AGRC	agricultural colony	a tract of land set aside for agricultural settlement
AMUS	amusement park	Amusement Park are theme parks, adventure parks offering entertainment, similar to funfairs but with a fix location
AREA	area	a tract of land without homogeneous character or boundaries
BSND	drainage basin	an area drained by a stream
BSNP	petroleum basin	an area underlain by an oil-rich structural basin
BTL	battlefield	a site of a land battle of historical importance
CLG	clearing	an area in a forest with trees removed
CMN	common	a park or pasture for community use
CNS	concession area	a lease of land by a government for economic development, e.g., mining, forestry
COLF	coalfield	a region in which coal deposits of possible economic value occur
CONT	continent	continent: Europe, Africa, Asia, North America, South America, Oceania, Antarctica
CST	coast	a zone of variable width straddling the shoreline
CTRB	business center	a place where a number of businesses are located
DEVH	housing development	a tract of land on which many houses of similar design are built according to a development plan
FLD	field(s)	an open as opposed to wooded area
FLDI	irrigated field(s)	a tract of level or terraced land which is irrigated
GASF	gasfield	an area containing a subterranean store of natural gas of economic value
GRAZ	grazing area	an area of grasses and shrubs used for grazing
GVL	gravel area	an area covered with gravel
INDS	industrial area	an area characterized by industrial activity
LAND	arctic land	a tract of land in the Arctic
LCTY	locality	a minor area or place of unspecified or mixed character and indefinite boundaries
MILB	military base	a place used by an army or other armed service for storing arms and supplies, and for accommodating and training troops, a base from which operations can be initiated
MNA	mining area	an area of mine sites where minerals and ores are extracted
MVA	maneuver area	a tract of land where military field exercises are carried out
NVB	naval base	an area used to store supplies, provide barracks for troops and naval personnel, a port for naval vessels, and from which operations are initiated
OAS	oasis(-es)	an area in a desert made productive by the availability of water
OILF	oilfield	an area containing a subterranean store of petroleum of economic value
PEAT	peat cutting area	an area where peat is harvested
PRK	park	an area, often of forested land, maintained as a place of beauty, or for recreation
PRT	port	a place provided with terminal and transfer facilities for loading and discharging waterborne cargo or passengers, usually located in a harbor
QCKS	quicksand	an area where loose sand with water moving through it may become unstable when heavy objects are placed at the surface, causing them to sink
RES	reserve	a tract of public land reserved for future use or restricted as to use
RESA	agricultural reserve	a tract of land reserved for agricultural reclamation and/or development
RESF	forest reserve	a forested area set aside for preservation or controlled use
RESH	hunting reserve	a tract of land used primarily for hunting
RESN	nature reserve	an area reserved for the maintenance of a natural habitat
RESP	palm tree reserve	an area of palm trees where use is controlled
RESV	reservation	a tract of land set aside for aboriginal, tribal, or native populations
RESW	wildlife reserve	a tract of public land reserved for the preservation of wildlife
RGN	region	an area distinguished by one or more observable physical or cultural characteristics
RGNE	economic region	a region of a country established for economic development or for statistical purposes
RGNH	historical region	a former historic area distinguished by one or more observable physical or cultural characteristics
RGNL	lake region	a tract of land distinguished by numerous lakes
RNGA	artillery range	a tract of land used for artillery firing practice
SALT	salt area	a shallow basin or flat where salt accumulates after periodic inundation
SNOW	snowfield	an area of permanent snow and ice forming the accumulation area of a glacier
TRB	tribal area	a tract of land used by nomadic or other tribes
