ASPH	asphalt lake	a small basin containing naturally occurring asphalt
ATOL	atoll(s)	a ring-shaped coral reef which has closely spaced islands on it encircling a lagoon
BAR	bar	a shallow ridge or mound of coarse unconsolidated material in a stream channel, at the mouth of a stream, estuary, or lagoon and in the wave-break zone along coasts
BCH	beach	a shore zone of coarse unconsolidated sediment that extends from the low-water line to the highest reach of storm waves
BCHS	beaches	a shore zone of coarse unconsolidated sediment that extends from the low-water line to the highest reach of storm waves
BDLD	badlands	an area characterized by a maze of very closely spaced, deep, narrow, steep-sided ravines, and sharp crests and pinnacles
BLDR	boulder field	a high altitude or high latitude bare, flat area covered with large angular rocks
BLHL	blowhole(s)	a hole in coastal rock through which sea water is forced by a rising tide or waves and spurted through an outlet into the air
BLOW	blowout(s)	a small depression in sandy terrain, caused by wind erosion
BNCH	bench	a long, narrow bedrock platform bounded by steeper slopes above and below, usually overlooking a waterbody
BUTE	butte(s)	a small, isolated, usually flat-topped hill with steep sides
CAPE	cape	a land area, more prominent than a point, projecting into the sea and marking a notable change in coastal direction
CFT	cleft(s)	a deep narrow slot, notch, or groove in a coastal cliff
CLDA	caldera	a depression measuring kilometers across formed by the collapse of a volcanic mountain
CLF	cliff(s)	a high, steep to perpendicular slope overlooking a waterbody or lower area
CNYN	canyon	a deep, narrow valley with steep sides cutting into a plateau or mountainous area
CONE	cone(s)	a conical landform composed of mud or volcanic material
CRDR	corridor	a strip or area of land having significance as an access way
CRQ	cirque	a bowl-like hollow partially surrounded by cliffs or steep slopes at the head of a glaciated valley
CRQS	cirques	bowl-like hollows partially surrounded by cliffs or steep slopes at the head of a glaciated valley
CRTR	crater(s)	a generally circular saucer or bowl-shaped depression caused by volcanic or meteorite explosive action
CUET	cuesta(s)	an asymmetric ridge formed on tilted strata
DLTA	delta	a flat plain formed by alluvial deposits at the mouth of a stream
DPR	depression(s)	a low area surrounded by higher land and usually characterized by interior drainage
DSRT	desert	a large area with little or no vegetation due to extreme environmental conditions
DUNE	dune(s)	a wave form, ridge or star shape feature composed of sand
DVD	divide	a line separating adjacent drainage basins
ERG	sandy desert	an extensive tract of shifting sand and sand dunes
FAN	fan(s)	a fan-shaped wedge of coarse alluvium with apex merging with a mountain stream bed and the fan spreading out at a low angle slope onto an adjacent plain
FORD	ford	a shallow part of a stream which can be crossed on foot or by land vehicle
FSR	fissure	a crack associated with volcanism
GAP	gap	a low place in a ridge, not used for transportation
GRGE	gorge(s)	a short, narrow, steep-sided section of a stream valley
HDLD	headland	a high projection of land extending into a large body of water beyond the line of the coast
HLL	hill	a rounded elevation of limited extent rising above the surrounding land with local relief of less than 300m
HLLS	hills	rounded elevations of limited extent rising above the surrounding land with local relief of less than 300m
HMCK	hammock(s)	a patch of ground, distinct from and slightly above the surrounding plain or wetland. Often occurs in groups
HMDA	rock desert	a relatively sand-free, high bedrock plateau in a hot desert, with or without a gravel veneer
INTF	interfluve	a relatively undissected upland between adjacent stream valleys
ISL	island	a tract of land, smaller than a continent, surrounded by water at high water
ISLET	islet	small island, bigger than rock, smaller than island.
ISLF	artificial island	an island created by landfill or diking and filling in a wetland, bay, or lagoon
ISLM	mangrove island	a mangrove swamp surrounded by a waterbody
ISLS	islands	tracts of land, smaller than a continent, surrounded by water at high water
ISLT	land-tied island	a coastal island connected to the mainland by barrier beaches, levees or dikes
ISLX	section of island	
ISTH	isthmus	a narrow strip of land connecting two larger land masses and bordered by water
KRST	karst area	a distinctive landscape developed on soluble rock such as limestone characterized by sinkholes, caves, disappearing streams, and underground drainage
LAVA	lava area	an area of solidified lava
LEV	levee	a natural low embankment bordering a distributary or meandering stream; often built up artificially to control floods
MESA	mesa(s)	a flat-topped, isolated elevation with steep slopes on all sides, less extensive than a plateau
MND	mound(s)	a low, isolated, rounded hill
MRN	moraine	a mound, ridge, or other accumulation of glacial till
MT	mountain	an elevation standing high above the surrounding area with small summit area, steep slopes and local relief of 300m or more
MTS	mountains	a mountain range or a group of mountains or high ridges
NKM	meander neck	a narrow strip of land between the two limbs of a meander loop at its narrowest point
NTK	nunatak	a rock or mountain peak protruding through glacial ice
NTKS	nunataks	rocks or mountain peaks protruding through glacial ice
PAN	pan	a near-level shallow, natural depression or basin, usually containing an intermittent lake, pond, or pool
PANS	pans	a near-level shallow, natural depression or basin, usually containing an intermittent lake, pond, or pool
PASS	pass	a break in a mountain range or other high obstruction, used for transportation from one side to the other [See also gap]
PEN	peninsula	an elongate area of land projecting into a body of water and nearly surrounded by water
PENX	section of peninsula	
PK	peak	a pointed elevation atop a mountain, ridge, or other hypsographic feature
PKS	peaks	pointed elevations atop a mountain, ridge, or other hypsographic features
PLAT	plateau	an elevated plain with steep slopes on one or more sides, and often with incised streams
PLATX	section of plateau	
PLDR	polder	an area reclaimed from the sea by diking and draining
PLN	plain(s)	an extensive area of comparatively level to gently undulating land, lacking surface irregularities, and usually adjacent to a higher area
PLNX	section of plain	
PROM	promontory(-ies)	a bluff or prominent hill overlooking or projecting into a lowland
PT	point	a tapering piece of land projecting into a body of water, less prominent than a cape
PTS	points	tapering pieces of land projecting into a body of water, less prominent than a cape
RDGB	beach ridge	a ridge of sand just inland and parallel to the beach, usually in series
RDGE	ridge(s)	a long narrow elevation with steep sides, and a more or less continuous crest
REG	stony desert	a desert plain characterized by a surface veneer of gravel and stones
RK	rock	a conspicuous, isolated rocky mass
RKFL	rockfall	an irregular mass of fallen rock at the base of a cliff or steep slope
RKS	rocks	conspicuous, isolated rocky masses
SAND	sand area	a tract of land covered with sand
SBED	dry stream bed	a channel formerly containing the water of a stream
SCRP	escarpment	a long line of cliffs or steep slopes separating level surfaces above and below
SDL	saddle	a broad, open pass crossing a ridge or between hills or mountains
SHOR	shore	a narrow zone bordering a waterbody which covers and uncovers at high and low water, respectively
SINK	sinkhole	a small crater-shape depression in a karst area
SLID	slide	a mound of earth material, at the base of a slope and the associated scoured area
SLP	slope(s)	a surface with a relatively uniform slope angle
SPIT	spit	a narrow, straight or curved continuation of a beach into a waterbody
SPUR	spur(s)	a subordinate ridge projecting outward from a hill, mountain or other elevation
TAL	talus slope	a steep concave slope formed by an accumulation of loose rock fragments at the base of a cliff or steep slope
TRGD	interdune trough(s)	a long wind-swept trough between parallel longitudinal dunes
TRR	terrace	a long, narrow alluvial platform bounded by steeper slopes above and below, usually overlooking a waterbody
UPLD	upland	an extensive interior region of high land with low to moderate surface relief
VAL	valley	an elongated depression usually traversed by a stream
VALG	hanging valley	a valley the floor of which is notably higher than the valley or shore to which it leads; most common in areas that have been glaciated
VALS	valleys	elongated depressions usually traversed by a stream
VALX	section of valley	
VLC	volcano	a conical elevation composed of volcanic materials with a crater at the top